частности -> loct,inan,NOUN,femn,sing
будущего -> NOUN,neut,gent,sing,inan
разработчики -> anim,NOUN,plur,masc,nomn
таблиц -> NOUN,femn,plur,gent,inan
университете -> masc,sing,NOUN,loct,inan
возможностей -> NOUN,femn,inan,gent,plur
долю -> NOUN,femn,accs,sing,inan
повышения -> inan,gent,neut,sing,NOUN
паутину -> accs,sing,femn,NOUN,inan
документ -> NOUN,masc,nomn,inan,sing
приступил -> VERB,indc,perf,intr,sing,masc,past
объектам -> datv,NOUN,plur,inan,masc
очень -> ADVB
выбором -> inan,NOUN,ablt,masc,sing
занимающейся -> intr,impf,femn,gent,sing,actv,pres,PRTF
обрабатываются -> pres,VERB,intr,3per,plur,indc,impf
помочь -> intr,INFN,perf
хотя -> CONJ
казалась -> impf,femn,indc,VERB,sing,intr,past
голдберг -> Surn,sing,masc,Sgtm,NOUN,nomn,anim
объединившая -> perf,actv,PRTF,past,nomn,femn,tran,sing
сделаны -> perf,PRTS,past,pssv,plur
выбор -> sing,nomn,NOUN,masc,inan
компьютерных -> plur,ADJF,gent
гостей -> anim,plur,NOUN,gent,masc
экране -> masc,inan,NOUN,sing,loct
проект -> masc,sing,inan,nomn,NOUN
проектора -> NOUN,gent,sing,masc,inan
новом -> masc,sing,ADJF,loct,Qual
заключил -> perf,indc,tran,sing,VERB,masc,past
пользовались -> indc,past,impf,plur,intr,VERB
концептуализировать -> tran,INFN,perf
программой -> femn,NOUN,inan,ablt,sing
воротничков -> plur,masc,gent,inan,NOUN
каждого -> sing,neut,ADJF,gent,Apro
отвратившая -> femn,nomn,PRTF,sing,tran,perf,actv,past
тревогу -> accs,inan,femn,NOUN,sing
у -> PREP
переориентировать -> tran,INFN,perf
тем -> CONJ
языков -> plur,anim,gent,masc,NOUN
применим -> sing,Qual,masc,ADJS
отдельно -> ADVB
называют -> indc,VERB,3per,tran,impf,plur,pres
отражение -> sing,accs,NOUN,inan,neut
рынка -> inan,masc,sing,NOUN,gent
таблицами -> plur,inan,NOUN,ablt,femn
названием -> inan,sing,ablt,NOUN,neut
продажи -> inan,NOUN,femn,gent,sing
господство -> NOUN,sing,neut,nomn,inan
всплывающими -> impf,PRTF,intr,plur,pres,actv,ablt
ней -> loct,3per,Anph,sing,femn,Af-p,NPRO
талантливый -> masc,ADJF,Qual,nomn,sing
через -> PREP
star -> LATN
одни -> nomn,Apro,plur,ADJF
чтобы -> CONJ
продукт -> masc,NOUN,inan,sing,nomn
процессора -> gent,masc,sing,inan,NOUN
шаг -> nomn,sing,NOUN,inan,masc
пауэлла -> NOUN,sing,Name,nomn,anim,femn
средой -> sing,ablt,inan,femn,NOUN
мечты -> inan,gent,femn,sing,NOUN
арена -> NOUN,masc,sing,Name,gent,anim
известных -> plur,ADJF,Qual,gent
она -> femn,sing,3per,Anph,nomn,NPRO
pc -> LATN
перезапустить -> perf,tran,INFN
десятилетии -> neut,inan,NOUN,loct,sing
английскому -> ADJF,datv,sing,masc
используем -> futr,perf,VERB,plur,indc,tran,1per
настолько -> ADVB,Dmns
поражен -> sing,masc,PRTS,perf,pssv,past
получать -> impf,INFN,tran
кабинетах -> loct,masc,inan,plur,NOUN
давно -> ADVB
списки -> masc,NOUN,inan,plur,accs
аланом -> masc,Name,sing,ablt,NOUN,anim
им -> gent,Abbr,NOUN,sing,inan,neut
сделать -> tran,perf,INFN
ликвидировать -> INFN,perf,tran
коммуникационных -> plur,gent,ADJF
apple -> LATN
минут -> plur,gent,femn,NOUN,inan
выступление -> sing,NOUN,nomn,inan,neut
примитивные -> plur,nomn,ADJF,Qual
получил -> past,masc,VERB,indc,sing,perf,tran
стало -> past,intr,indc,sing,neut,VERB,perf
другие -> Apro,plur,Subx,ADJF,nomn
презентациях -> femn,plur,loct,NOUN,inan
встроенные -> past,nomn,pssv,Adjx,tran,PRTF,perf,plur
как -> CONJ
означало -> tran,indc,VERB,past,sing,impf,neut
прошло -> sing,ADJS,neut
напрямую -> ADVB
кэмпбелл -> Name,anim,gent,femn,NOUN,plur
систем -> femn,gent,inan,plur,NOUN
сосредоточилась -> VERB,perf,intr,indc,sing,femn,past
советом -> masc,ablt,sing,NOUN,inan
файловым -> ablt,masc,sing,ADJF
трудностями -> ablt,inan,femn,plur,NOUN
содержали -> tran,past,impf,plur,VERB,indc
среде -> inan,femn,NOUN,sing,loct
центральным -> datv,plur,ADJF
программировании -> neut,inan,sing,loct,NOUN
погрузилась -> indc,sing,intr,past,femn,VERB,perf
миллионов -> plur,NOUN,masc,gent,inan
компанию -> sing,femn,accs,NOUN,inan
принтере -> masc,NOUN,loct,sing,inan
деловые -> plur,nomn,ADJF
затем -> ADVB,Dmns
манипулировать -> INFN,impf,intr
стандартной -> ADJF,sing,femn,Qual,gent
если -> CONJ
alto -> LATN
представители -> masc,anim,plur,nomn,NOUN
появления -> neut,sing,gent,inan,NOUN
software -> LATN
финансируемым -> impf,ablt,pssv,pres,PRTF,sing,tran,masc
компьютером -> sing,NOUN,masc,ablt,inan
известный -> nomn,Qual,masc,ADJF,sing
за -> PREP
несколько -> ADVB
размере -> sing,NOUN,loct,masc,inan
того -> Apro,sing,Anph,Subx,gent,ADJF,neut
главе -> inan,femn,datv,sing,NOUN
изменений -> neut,plur,inan,NOUN,gent
выполнения -> inan,NOUN,neut,gent,sing
понравилось -> sing,past,neut,VERB,intr,indc,perf
платформу -> femn,accs,inan,sing,NOUN
пользователю -> NOUN,sing,masc,anim,datv
генерировали -> indc,impf,past,plur,tran,VERB
всё -> neut,ADJF,sing,Apro,nomn
программа -> femn,sing,NOUN,nomn,inan
одного -> sing,ADJF,neut,Apro,gent
это -> PRCL
меллоне -> neut,loct,inan,sing,NOUN
миру -> sing,datv,masc,NOUN,inan
ими -> Anph,3per,ablt,NPRO,plur
пк -> NOUN,nomn,masc,inan,Fixd,Abbr,sing
со -> Vpre,PREP
имели -> indc,VERB,tran,impf,plur,past
среднем -> NOUN,inan,sing,loct,neut
цене -> femn,inan,sing,NOUN,loct
встречи -> inan,NOUN,sing,gent,femn
переворот -> inan,NOUN,masc,accs,sing
годами -> ADVB
самый -> nomn,sing,masc,ADJF,Apro
первую -> sing,Anum,femn,ADJF,accs
опыт -> nomn,inan,masc,sing,NOUN
примечание -> NOUN,sing,inan,neut,nomn
мм -> INTJ
кремниевой -> femn,sing,ADJF,Qual,gent
яркое -> nomn,neut,ADJF,sing,Qual
разработанный -> pssv,sing,masc,PRTF,perf,tran,nomn,past
перекрывающимися -> actv,plur,PRTF,impf,intr,pres,ablt
современном -> ADJF,Qual,loct,sing,masc
обороты -> accs,NOUN,masc,inan,plur
создатели -> NOUN,masc,anim,nomn,plur
вызвало -> perf,sing,past,neut,VERB,tran,indc
х -> UNKN
свою -> sing,accs,Anph,ADJF,Apro,femn
сказать -> perf,INFN,tran
офисы -> NOUN,masc,accs,inan,plur
вычислительных -> gent,plur,ADJF
сторонники -> plur,masc,nomn,anim,NOUN
конкурентная -> ADJF,sing,femn,nomn
самого -> Apro,ADJF,masc,gent,sing
собой -> sing,ablt,NPRO,Anph
вся -> ADJF,Apro,femn,sing,nomn
будет -> VERB,3per,futr,impf,sing,intr,indc
преимущества -> sing,neut,gent,inan,NOUN
способов -> NOUN,inan,gent,masc,plur
статистический -> ADJF,masc,sing,nomn
любую -> femn,sing,ADJF,Apro,accs
подразумевал -> past,VERB,impf,tran,indc,sing,masc
электронную -> ADJF,femn,sing,accs
тратами -> plur,NOUN,ablt,inan,femn
сформирует -> sing,3per,tran,indc,VERB,perf,futr
щелчку -> sing,masc,datv,NOUN,inan
графическую -> sing,accs,femn,ADJF
произнесения -> gent,inan,NOUN,neut,sing
явно -> ADVB
редмонд -> NOUN,inan,nomn,sing,masc
руководителей -> gent,NOUN,plur,anim,masc
главной -> sing,femn,ablt,ADJF,Qual
млрд -> Abbr,masc,sing,nomn,inan,NOUN,Fixd
libreoffice -> LATN
сопоставимо -> neut,ADJS,sing
сотрудничали -> impf,VERB,intr,plur,past,indc
воплотились -> intr,VERB,plur,indc,past,perf
бухгалтерии -> femn,gent,NOUN,inan,sing
сохранились -> plur,indc,perf,past,VERB,intr
обеспечение -> inan,neut,NOUN,nomn,sing
адель -> anim,nomn,Name,femn,Fixd,sing,NOUN,Sgtm
подход -> masc,nomn,inan,NOUN,sing
обороны -> femn,sing,NOUN,gent,inan
забегать -> INFN,impf,intr
выгодной -> Qual,ADJF,gent,femn,sing
первым -> ADJF,ablt,sing,Anum,masc
которыми -> plur,ablt,ADJF,Anph,Apro,Subx
объединивший -> nomn,sing,actv,masc,PRTF,past,perf,tran
пивот -> masc,inan,nomn,sing,NOUN
основными -> ablt,Qual,plur,ADJF
бесплатными -> plur,Qual,ablt,ADJF
бизнеса -> sing,gent,masc,inan,NOUN
самым -> Apro,datv,plur,ADJF
любого -> masc,sing,gent,NPRO
живым -> masc,ablt,sing,NOUN,anim
приостановлена -> pssv,PRTS,perf,sing,femn,past
уже -> ADVB
поступил -> perf,VERB,intr,sing,past,masc,indc
pascal -> LATN
есть -> INTJ
лавры -> gent,NOUN,femn,sing,inan
молодого -> ADJF,neut,Qual,gent,sing
долларов -> plur,NOUN,masc,inan,gent
данные -> pssv,PRTF,plur,nomn,past,perf,tran
человека -> masc,gent,NOUN,anim,sing
рудкин -> NOUN,plur,inan,femn,gent
понял -> sing,masc,tran,VERB,perf,indc,past
издательское -> neut,sing,ADJF,nomn
получили -> perf,plur,VERB,tran,indc,past
клавиатуры -> femn,sing,gent,inan,NOUN
капотом -> inan,ablt,masc,sing,NOUN
безопасности -> gent,inan,sing,femn,NOUN
graphics -> LATN
отображаемые -> nomn,impf,pres,plur,tran,pssv,PRTF
головы -> Ms-f,Pltm,nomn,GNdr,plur,Surn,NOUN,anim
требовались -> past,intr,impf,plur,VERB,indc
упрочилось -> past,VERB,intr,neut,sing,indc,perf
подобной -> Subx,gent,Qual,ADJF,femn,sing
одно -> accs,ADJF,Apro,sing,neut
пугающий -> masc,impf,sing,Adjx,actv,pres,nomn,tran,PRTF
где -> ADVB,Ques
участвовал -> indc,impf,sing,intr,masc,past,VERB
центре -> inan,loct,sing,NOUN,masc
tcp -> LATN
никакой -> gent,Apro,femn,sing,ADJF
какое -> Apro,ADJF,sing,neut,accs
нужное -> ADJF,Qual,nomn,sing,neut
той -> femn,sing,Subx,Anph,ablt,ADJF,Apro
row -> LATN
линеек -> plur,inan,NOUN,gent,femn
персонального -> ADJF,gent,masc,sing
wysiwyg -> LATN
или -> CONJ
заключения -> inan,sing,gent,neut,NOUN
arpa -> LATN
кризис -> inan,nomn,NOUN,sing,masc
пользовательский -> sing,ADJF,masc,nomn
шутку -> inan,sing,accs,NOUN,femn
которое -> neut,nomn,Subx,ADJF,Apro,Anph,sing
выводить -> perf,INFN,tran
перед -> PREP
презентацию -> NOUN,inan,femn,accs,sing
разрабатывать -> tran,INFN,impf
деннис -> masc,NOUN,Name,sing,nomn,anim
прежде -> ADVB
нескольких -> gent,NUMR
laserwriter -> LATN
взаимодействовать -> intr,INFN,impf
даром -> ADVB
года -> gent,masc,sing,NOUN,inan
этом -> neut,sing,NPRO,loct
апреле -> inan,NOUN,masc,sing,loct
офис -> sing,NOUN,masc,nomn,inan
ip -> LATN
кодоскопом -> ADVB
чертежи -> plur,inan,nomn,masc,NOUN
электронные -> nomn,plur,ADJF
чашек -> plur,NOUN,gent,inan,femn
пример -> accs,NOUN,masc,sing,inan
зал -> inan,accs,NOUN,sing,masc
развивается -> pres,intr,VERB,impf,3per,indc,sing
решил -> past,tran,indc,VERB,masc,perf,sing
обычными -> ADJF,Qual,plur,ablt
блоки -> NOUN,masc,accs,plur,inan
силой -> ADVB
образовали -> past,VERB,tran,perf,indc,plur
нанял -> past,tran,perf,sing,VERB,indc,masc
инструмента -> NOUN,gent,sing,masc,inan
сообществе -> inan,loct,NOUN,neut,sing
каждый -> Apro,accs,sing,ADJF,inan,masc
имелась -> sing,indc,impf,femn,intr,past,VERB
примечательно -> ADVB
microsoft -> LATN
осуществлялось -> intr,neut,sing,VERB,impf,indc,past
пока -> ADVB
еще -> PRCL
функции -> NOUN,femn,sing,gent,inan
пакетирования -> gent,inan,neut,Sgtm,NOUN,sing
был -> indc,masc,impf,sing,VERB,intr,past
невозможно -> Prdx,ADVB
конкурировать -> INFN,intr,impf
будущем -> sing,loct,neut,NOUN,inan
пожалуй -> PRCL
парадигмой -> femn,ablt,sing,NOUN,inan
очередь -> inan,NOUN,accs,sing,femn
речь -> sing,femn,nomn,inan,NOUN
сортировщик -> nomn,masc,sing,anim,NOUN
изменилось -> intr,VERB,past,neut,indc,sing,perf
назвали -> tran,past,VERB,perf,indc,plur
создавать -> impf,INFN,tran
знаем -> tran,impf,plur,VERB,indc,pres,1per
пауэлл -> gent,plur,Name,femn,anim,NOUN
которой -> sing,ADJF,Subx,femn,Apro,loct,Anph
секретарь -> anim,NOUN,nomn,masc,sing
мог -> VERB,masc,indc,intr,sing,past,impf
показа -> NOUN,inan,sing,gent,masc
забавно -> ADVB,Prdx
двумя -> ablt,masc,NUMR
графическое -> neut,nomn,ADJF,sing
целую -> pres,impf,VERB,1per,sing,tran,indc
собственную -> ADJF,accs,sing,femn
привыкла -> perf,femn,intr,VERB,past,indc,sing
компьютеров -> gent,NOUN,masc,plur,inan
горячие -> inan,plur,nomn,neut,NOUN
которая -> nomn,ADJF,sing,Anph,Apro,Subx,femn
сотрудники -> anim,plur,NOUN,nomn,masc
сильного -> ADJF,neut,gent,sing,Qual
красочных -> Qual,plur,ADJF,gent
имени -> sing,gent,inan,neut,NOUN
что -> CONJ
офиса -> masc,NOUN,inan,sing,gent
нежели -> CONJ
программирование -> inan,nomn,sing,NOUN,neut
ранее -> ADVB
названный -> PRTF,tran,nomn,perf,past,sing,masc,pssv
важное -> ADJF,sing,neut,Qual,nomn
не -> PRCL
стеснена -> pssv,PRTS,femn,past,perf,sing
беспокоились -> intr,past,VERB,impf,indc,plur
собственного -> neut,sing,ADJF,gent
распространение -> neut,sing,NOUN,nomn,inan
просмотра -> masc,gent,NOUN,inan,sing
динамичность -> inan,femn,NOUN,sing,nomn
минуя -> pres,tran,GRND,impf
гибкость -> inan,accs,NOUN,femn,sing
элиты -> femn,gent,sing,inan,NOUN
контракта -> gent,masc,NOUN,inan,sing
лошадок -> gent,anim,NOUN,plur,femn
отделах -> NOUN,masc,plur,inan,loct
нет -> pres,PRED
покинувшим -> perf,sing,ablt,actv,PRTF,masc,tran,past
слайдов -> masc,NOUN,plur,gent,inan
поле -> NOUN,masc,Name,anim,sing,loct
другом -> masc,anim,NOUN,sing,ablt
цикл -> sing,inan,masc,nomn,NOUN
этой -> gent,Anph,femn,ADJF,sing,Apro,Subx
огромный -> sing,masc,nomn,ADJF,Qual
корпоративные -> ADJF,nomn,plur
проданных -> past,tran,plur,pssv,PRTF,gent,perf
ориентированное -> pssv,neut,tran,perf,sing,nomn,PRTF,past
стали -> perf,intr,indc,VERB,plur,past
рынок -> NOUN,sing,inan,masc,accs
началу -> NOUN,neut,sing,inan,datv
молодые -> NOUN,plur,femn,nomn,anim
чистой -> femn,ADJF,datv,Qual,sing
программным -> ablt,sing,ADJF,masc
словом -> ablt,sing,neut,inan,NOUN
создании -> neut,loct,NOUN,ANim,sing
во -> Vpre,PREP
активно -> ADVB
выпускало -> past,VERB,indc,sing,neut,tran,impf
среднего -> sing,neut,NOUN,gent,inan
подсчет -> NOUN,masc,accs,inan,sing
работало -> intr,impf,VERB,past,indc,sing,neut
разработчика -> anim,NOUN,accs,sing,masc
пояснительного -> masc,sing,ADJF,gent
harvard -> LATN
компаниями -> plur,NOUN,ablt,femn,inan
элемент -> inan,sing,nomn,masc,NOUN
недорогого -> ADJF,masc,gent,sing
прочими -> ADJF,ablt,Apro,plur
становилось -> indc,sing,VERB,intr,neut,past,impf
связывать -> impf,tran,INFN
и -> CONJ
никто -> NPRO,nomn,sing
воротничками -> NOUN,plur,masc,ablt,inan
объединяются -> VERB,intr,3per,plur,pres,indc,impf
стоимостью -> femn,NOUN,inan,ablt,sing
чувствовали -> past,indc,VERB,impf,plur,tran
маркированные -> ADJF,plur,nomn
утереть -> tran,perf,INFN
их -> 3per,plur,Anph,gent,NPRO
белых -> Ms-f,Surn,anim,GNdr,nomn,sing,Fixd,NOUN
представила -> perf,VERB,indc,femn,sing,past,tran
большую -> sing,femn,ADJF,Qual,accs
предлагаемых -> pres,plur,tran,pssv,PRTF,impf,gent
программах -> plur,inan,femn,loct,NOUN
основатели -> NOUN,plur,nomn,anim,masc
нанятые -> PRTF,pssv,tran,perf,nomn,plur,past
почту -> femn,sing,inan,accs,NOUN
сути -> NOUN,femn,datv,inan,sing
наступил -> intr,indc,masc,VERB,past,sing,perf
персональных -> ADJF,plur,gent
отставал -> intr,sing,impf,VERB,indc,masc,past
популярный -> Qual,ADJF,sing,masc,nomn
удалось -> intr,neut,past,sing,indc,VERB,perf
виде -> sing,loct,NOUN,inan,masc
превратился -> sing,perf,intr,indc,VERB,past,masc
звена -> neut,gent,inan,NOUN,sing
новым -> ADJF,datv,Qual,plur
вещь -> femn,NOUN,inan,nomn,sing
примерно -> ADVB
будем -> futr,impf,1per,indc,plur,VERB,intr
отчет -> inan,accs,NOUN,masc,sing
электронных -> gent,plur,ADJF
прорывной -> femn,ADJF,sing,gent
текста -> inan,sing,NOUN,gent,masc
стол -> masc,inan,sing,NOUN,accs
результатом -> masc,NOUN,ablt,sing,inan
word -> LATN
целый -> accs,ADJF,masc,sing,Qual,inan
все -> nomn,plur,ADJF,Apro
времен -> inan,gent,NOUN,plur,neut
позаимствовал -> perf,VERB,sing,past,masc,tran,indc
стала -> indc,VERB,past,perf,femn,intr,sing
другого -> ADJF,neut,sing,gent,Subx,Apro
легендарном -> ADJF,sing,masc,loct
были -> plur,VERB,past,impf,indc,intr
примеру -> inan,masc,datv,NOUN,sing
компанией -> ablt,femn,sing,NOUN,inan
выглядеть -> perf,tran,INFN
наработки -> gent,sing,inan,NOUN,femn
гости -> nomn,masc,plur,NOUN,anim
считать -> INFN,tran,perf
спикером -> anim,NOUN,sing,masc,ablt
привычные -> Qual,nomn,plur,ADJF
сохранить -> perf,tran,INFN
раз -> inan,accs,sing,masc,NOUN
работы -> inan,sing,femn,NOUN,gent
помощью -> NOUN,sing,inan,femn,ablt
контекстными -> ADJF,ablt,plur,Qual
кто -> sing,NPRO,masc,nomn
популярных -> Qual,ADJF,plur,gent
генерировать -> INFN,tran,impf
из -> PREP
corp -> LATN
разработчик -> NOUN,anim,masc,sing,nomn
высокой -> femn,gent,Qual,ADJF,sing
время -> accs,inan,sing,NOUN,neut
контрактов -> gent,masc,plur,NOUN,inan
компьютеры -> accs,masc,plur,NOUN,inan
похоже -> Prnt,CONJ
в -> PREP
учеными -> plur,ablt,ADJF,Qual
стартовая -> sing,femn,nomn,ADJF,Qual
scotch -> LATN
утверждали -> VERB,plur,intr,impf,indc,past
печати -> sing,gent,femn,inan,NOUN
планетах -> masc,plur,loct,inan,NOUN
программированием -> NOUN,ablt,neut,inan,sing
имел -> impf,indc,past,sing,VERB,masc,tran
клонов -> inan,NOUN,gent,masc,plur
донести -> perf,INFN,tran
столкнулась -> sing,femn,perf,VERB,indc,past,intr
переключился -> sing,VERB,past,indc,masc,perf,intr
обеспечивает -> sing,impf,indc,tran,3per,VERB,pres
он -> masc,NPRO,Anph,nomn,3per,sing
западе -> sing,masc,loct,Geox,NOUN,inan
революционной -> sing,femn,gent,Qual,ADJF
перспективных -> plur,ADJF,Qual,gent
пор -> femn,gent,plur,inan,NOUN
компьютерщики -> plur,anim,NOUN,masc,nomn
хватало -> tran,sing,VERB,past,indc,impf,neut
начали -> perf,VERB,past,indc,tran,plur
продавать -> tran,INFN,impf
одном -> Apro,masc,sing,ADJF,loct
мышление -> nomn,neut,inan,NOUN,sing
когда -> CONJ
плодом -> NOUN,sing,ablt,masc,inan
возможности -> gent,NOUN,femn,inan,sing
слайды -> NOUN,nomn,plur,inan,masc
конце -> NOUN,inan,sing,loct,masc
мире -> loct,masc,NOUN,inan,sing
надежд -> femn,NOUN,plur,gent,inan
иногда -> ADVB
клиентов -> plur,NOUN,gent,masc,anim
положение -> accs,neut,NOUN,inan,sing
заявление -> neut,inan,NOUN,accs,sing
одним -> datv,plur,Apro,ADJF
рынку -> masc,sing,inan,NOUN,datv
presenter -> LATN
подобных -> Qual,gent,ADJF,Subx,plur
инженеры -> nomn,masc,plur,anim,NOUN
foundation -> LATN
без -> PREP
одновременно -> ADVB
macware -> LATN
идеи -> inan,sing,gent,NOUN,femn
пользователя -> anim,NOUN,sing,gent,masc
было -> sing,VERB,indc,intr,neut,past,impf
лет -> NOUN,gent,plur,masc,inan
языку -> datv,sing,masc,inan,NOUN
оон -> gent,sing,Fixd,inan,Sgtm,femn,Orgn,NOUN
копированием -> inan,ablt,sing,NOUN,neut
экзистенциальный -> ADJF,nomn,sing,masc
программу -> accs,femn,sing,inan,NOUN
презентаций -> NOUN,femn,inan,gent,plur
смартфоны -> NOUN,inan,nomn,plur,masc
результате -> sing,inan,NOUN,masc,loct
захватывать -> tran,INFN,impf
изменил -> perf,masc,past,indc,VERB,tran,sing
выпустила -> past,femn,indc,perf,tran,VERB,sing
качестве -> NOUN,sing,neut,inan,loct
представили -> VERB,indc,perf,plur,tran,past
терпение -> nomn,sing,neut,NOUN,inan
лопнуло -> VERB,intr,sing,indc,perf,past,neut
lotus -> LATN
ученый -> nomn,sing,masc,Qual,ADJF
текстового -> ADJF,gent,sing,masc
могло -> sing,neut,VERB,impf,past,intr,indc
инженерам -> datv,NOUN,plur,anim,masc
содержал -> VERB,past,sing,masc,tran,indc,impf
обеспечением -> inan,sing,ablt,neut,NOUN
пользователи -> plur,masc,nomn,NOUN,anim
комплект -> nomn,inan,masc,NOUN,sing
карнеги -> GNdr,anim,nomn,Fixd,Ms-f,sing,Surn,NOUN
продажам -> plur,femn,NOUN,datv,inan
сша -> inan,Fixd,Geox,gent,Pltm,NOUN,GNdr,plur
разработке -> sing,loct,inan,femn,NOUN
прекрасной -> sing,ablt,ADJF,femn,Qual
решила -> sing,VERB,femn,tran,indc,perf,past
сообщество -> inan,NOUN,sing,accs,neut
спустя -> PREP
universal -> LATN
включая -> PREP
стив -> Name,nomn,anim,NOUN,sing,masc
наши -> ADJF,plur,nomn,Apro
породит -> indc,sing,VERB,perf,3per,futr,tran
packard -> LATN
поддержкой -> sing,femn,ablt,inan,NOUN
запуска -> inan,masc,gent,NOUN,sing
велико -> sing,Qual,ADJS,neut
могут -> impf,pres,plur,intr,VERB,indc,3per
деле -> NOUN,loct,inan,neut,sing
интернете -> loct,masc,sing,NOUN,inan
видеодисплеи -> masc,nomn,plur,NOUN,inan
потенциал -> nomn,masc,inan,NOUN,sing
началась -> sing,perf,femn,indc,VERB,intr,past
отношение -> accs,NOUN,sing,neut,inan
предыдущем -> masc,loct,sing,ADJF
приобрела -> indc,VERB,tran,femn,perf,sing,past
склонить -> tran,INFN,perf
описывалась -> impf,past,VERB,indc,intr,sing,femn
компьютерным -> masc,ADJF,sing,ablt
заключалась -> indc,intr,sing,VERB,past,impf,femn
корпоративный -> sing,nomn,ADJF,masc
яркий -> sing,nomn,Qual,ADJF,masc
программисты -> masc,plur,NOUN,nomn,anim
программы -> femn,sing,NOUN,gent,inan
выглядят -> VERB,3per,intr,indc,pres,plur,impf
аналогичными -> plur,ablt,ADJF
госдепа -> gent,NOUN,inan,sing,masc
собственный -> ADJF,sing,accs,inan,masc
успех -> nomn,inan,sing,masc,NOUN
работу -> femn,sing,inan,accs,NOUN
программного -> gent,sing,neut,ADJF
тут -> Dmns,ADVB
лингвистике -> sing,femn,inan,NOUN,loct
информатике -> NOUN,inan,sing,datv,Sgtm,femn
интерфейс -> inan,sing,NOUN,masc,nomn
сеть -> inan,NOUN,sing,femn,nomn
государственный -> ADJF,nomn,masc,sing
долине -> loct,inan,sing,femn,NOUN
mahogany -> LATN
меньшие -> nomn,plur,ADJF
подкованы -> plur,past,PRTS,perf,pssv
кэмпбелла -> NOUN,nomn,femn,sing,anim,Name
на -> PREP
момент -> accs,inan,sing,NOUN,masc
форпостом -> NOUN,inan,masc,sing,ablt
совокупное -> ADJF,neut,sing,nomn,Qual
присоединился -> sing,perf,VERB,indc,intr,past,masc
предшественник -> nomn,anim,masc,sing,NOUN
этапом -> ablt,sing,NOUN,inan,masc
полман -> nomn,Name,sing,anim,masc,NOUN
году -> NOUN,masc,inan,sing,loc2
ни -> PRCL
включить -> INFN,tran,perf
бы -> PRCL
пингвинах -> NOUN,loct,anim,plur,masc
высокого -> ADJF,Qual,neut,gent,sing
бизнес -> nomn,sing,NOUN,masc,inan
действии -> inan,sing,NOUN,loct,neut
таблицы -> gent,femn,NOUN,inan,sing
точно -> ADVB
скоростью -> inan,ablt,sing,NOUN,femn
стационарные -> plur,nomn,ADJF
свыше -> ADVB
техносоциальном -> Qual,sing,ADJF,masc,loct
основа -> nomn,sing,femn,NOUN,inan
стартапа -> NOUN,masc,sing,inan,gent
всевозможные -> plur,ADJF,nomn
дни -> inan,plur,masc,NOUN,accs
текстовый -> ADJF,nomn,sing,masc
filemaker -> LATN
глубокий -> masc,nomn,Qual,ADJF,sing
собственном -> sing,ADJF,loct,masc
течение -> NOUN,neut,inan,sing,accs
влияние -> sing,NOUN,inan,neut,accs
энгельбарта -> Name,gent,masc,NOUN,anim,sing
приложении -> NOUN,loct,inan,sing,neut
исследователи -> anim,nomn,NOUN,plur,masc
джобс -> NOUN,sing,masc,inan,nomn
маркетингу -> sing,masc,inan,NOUN,datv
мощными -> ADJF,plur,ablt,Qual
также -> CONJ
самостоятельной -> ADJF,sing,femn,gent,Qual
коммерческого -> gent,masc,ADJF,sing
ibm -> LATN
программируемым -> sing,ablt,tran,pres,pssv,PRTF,masc,impf
ом -> inan,masc,nomn,sing,NOUN
копировать -> tran,INFN,impf
отображения -> sing,gent,NOUN,neut,inan
месяца -> inan,NOUN,masc,sing,gent
ним -> ablt,3per,Af-p,Anph,sing,NPRO,masc
выполнить -> perf,INFN,tran
годы -> inan,plur,accs,NOUN,masc
такой -> gent,sing,Apro,ADJF,femn
оставались -> intr,indc,plur,VERB,impf,past
фактически -> ADVB
ключевой -> nomn,ADJF,sing,masc
компьютерами -> NOUN,ablt,plur,masc,inan
управлял -> impf,past,masc,sing,VERB,indc,intr
подобном -> Qual,sing,Subx,ADJF,neut,loct
существующих -> ADJF,plur,gent
каким -> plur,datv,ADJF,Apro
распечатки -> femn,NOUN,gent,inan,sing
объектно -> ADJS,sing,Qual,neut
лично -> ADVB
объекты -> accs,plur,inan,NOUN,masc
колин -> Name,masc,nomn,sing,anim,NOUN
менеджеров -> gent,plur,masc,NOUN,anim
тому -> masc,datv,Subx,Anph,sing,ADJF,Apro
свойство -> NOUN,inan,nomn,neut,sing
компьютер -> sing,inan,nomn,NOUN,masc
слайда -> gent,NOUN,masc,sing,inan
ему -> Anph,masc,datv,3per,sing,NPRO
назад -> ADVB
операционной -> ADJF,sing,femn,gent
подробно -> ADVB
разработки -> femn,sing,NOUN,gent,inan
переноситься -> INFN,intr,impf
удаленными -> Qual,ADJF,ablt,plur
её -> Fixd,Apro,neut,gent,sing,ADJF,Anph
затягивается -> indc,impf,pres,intr,3per,sing,VERB
жизненный -> ADJF,sing,masc,nomn,Qual
между -> PREP
создания -> sing,ANim,NOUN,neut,gent
жизнь -> inan,NOUN,sing,accs,femn
бесплатной -> Qual,ADJF,gent,sing,femn
пало -> intr,neut,perf,indc,VERB,past,sing
новый -> masc,ADJF,inan,sing,Qual,accs
гаскинс -> Name,sing,masc,anim,nomn,NOUN
занимали -> impf,VERB,indc,tran,past,plur
прозрачные -> Qual,nomn,plur,ADJF
поставлять -> INFN,tran,impf
представить -> INFN,perf,tran
исследовательском -> masc,ADJF,sing,loct
возглавлял -> VERB,indc,tran,impf,sing,masc,past
считалось -> past,VERB,impf,sing,intr,indc,neut
соседствовали -> intr,past,impf,VERB,indc,plur
написанных -> past,tran,PRTF,gent,plur,pssv,perf
лэмпсоном -> NOUN,ablt,anim,Sgtm,Surn,sing,masc
ноутбуки -> masc,plur,inan,NOUN,nomn
переговоры -> plur,Pltm,inan,NOUN,nomn,GNdr
сколько -> CONJ
февраля -> masc,sing,inan,NOUN,gent
далеко -> Prdx,ADVB
анализ -> nomn,NOUN,inan,masc,sing
отодвинул -> indc,sing,past,masc,perf,VERB,tran
процессор -> inan,NOUN,masc,nomn,sing
объединены -> past,plur,perf,pssv,PRTS
создателей -> gent,NOUN,plur,masc,anim
должен -> masc,sing,ADJS
собственной -> gent,sing,ADJF,femn
постарались -> VERB,plur,past,intr,indc,perf
теперь -> ADVB
переходы -> NOUN,masc,inan,nomn,plur
прокрутки -> gent,femn,inan,NOUN,sing
программ -> plur,inan,NOUN,gent,femn
полдюжины -> NOUN,inan,sing,neut,Sgtm,nomn
друг -> masc,NOUN,nomn,anim,sing
долго -> ADVB
любимой -> Qual,sing,femn,ADJF,Subx,gent
тейлора -> sing,Surn,Sgtm,NOUN,masc,gent,anim
компании -> NOUN,sing,femn,inan,gent
солнечной -> gent,Qual,femn,sing,ADJF
нас -> gent,plur,1per,NPRO
создавал -> sing,VERB,past,masc,tran,impf,indc
глубоко -> ADVB
большим -> ablt,masc,sing,ADJF
создавшей -> actv,tran,sing,past,PRTF,femn,gent,perf
предполагаемые -> plur,PRTF,pssv,nomn,impf,pres,Adjx,tran
сторонними -> ablt,ADJF,plur
oracle -> LATN
разрабатываемый -> sing,PRTF,pres,impf,nomn,pssv,masc,tran
чуть -> ADVB
таких -> gent,ADJF,Apro,plur
остином -> masc,inan,nomn,NOUN,sing
внешними -> ablt,plur,ADJF
каких -> Apro,plur,loct,ADJF
фотографии -> femn,NOUN,inan,sing,gent
роберт -> sing,Name,NOUN,masc,nomn,anim
менеджером -> ablt,anim,masc,sing,NOUN
о -> PREP
занимался -> sing,masc,impf,indc,past,VERB,intr
соучредитель -> nomn,NOUN,sing,anim,masc
пленки -> gent,NOUN,inan,femn,sing
снова -> ADVB
копия -> NOUN,femn,nomn,sing,inan
звеном -> NOUN,neut,inan,ablt,sing
конфликтовали -> indc,past,plur,VERB,impf,intr
опытный -> sing,ADJF,masc,Qual,nomn
миллион -> sing,masc,inan,NOUN,accs
чаще -> inan,datv,NOUN,sing,femn
прибылью -> inan,NOUN,femn,ablt,sing
технологии -> inan,NOUN,gent,femn,sing
модульность -> femn,inan,NOUN,nomn,sing
документы -> inan,masc,NOUN,plur,accs
идеей -> sing,NOUN,femn,ablt,inan
документации -> sing,NOUN,gent,femn,inan
первой -> Anum,gent,femn,ADJF,sing
лазерном -> ADJF,masc,sing,loct
потратила -> indc,perf,VERB,tran,sing,femn,past
говоря -> GRND,tran,impf,pres
одной -> ADJF,sing,femn,gent,Apro
слайдах -> plur,NOUN,inan,loct,masc
делопроизводства -> inan,NOUN,neut,gent,sing
движущей -> sing,ADJF,gent,femn
роб -> plur,NOUN,femn,gent,inan
эрудитом -> NOUN,anim,ablt,sing,masc
обречен -> sing,ADJS,masc,Qual
истории -> loct,sing,femn,inan,NOUN
арт -> anim,Name,nomn,sing,masc,NOUN
штуку -> inan,NOUN,accs,femn,sing
спикер -> NOUN,masc,sing,nomn,anim
состояла -> past,VERB,intr,femn,sing,indc,impf
этим -> NPRO,sing,ablt,neut
вебинаров -> plur,Name,masc,gent,anim,NOUN
финансовые -> nomn,ADJF,plur
появились -> intr,plur,VERB,indc,past,perf
рабочий -> anim,masc,nomn,sing,NOUN
начала -> sing,inan,gent,NOUN,neut
показаться -> INFN,perf,intr
планировал -> indc,tran,masc,sing,past,VERB,impf
кеем -> ablt,masc,sing,NOUN,anim
цифровых -> ADJF,plur,gent
бухгалтерским -> ablt,ADJF,masc,sing
нового -> gent,inan,sing,NOUN,neut
позже -> Qual,COMP
условный -> ADJF,nomn,masc,Qual,sing
google -> LATN
нишу -> NOUN,accs,inan,femn,sing
вопрос -> sing,NOUN,nomn,inan,masc
которых -> gent,Apro,Subx,Anph,ADJF,plur
считали -> past,plur,VERB,perf,tran,indc
запускают -> pres,plur,indc,tran,VERB,impf,3per
вовсе -> ADVB
маркетинга -> NOUN,gent,sing,masc,inan
небольшой -> ADJF,masc,nomn,sing
нос -> masc,nomn,sing,NOUN,inan
тысяч -> gent,plur,NOUN,inan,femn
office -> LATN
подчеркнули -> indc,plur,perf,VERB,tran,past
речи -> NOUN,femn,sing,inan,gent
человек -> nomn,NOUN,sing,masc,anim
запуск -> masc,nomn,inan,sing,NOUN
продавалась -> intr,VERB,impf,sing,femn,indc,past
щелчком -> ablt,inan,NOUN,masc,sing
раздаче -> inan,datv,NOUN,femn,sing
данных -> gent,tran,past,perf,plur,PRTF,pssv
первые -> inan,plur,accs,ADJF,Anum
привлекая -> pres,tran,GRND,impf
клоны -> NOUN,masc,nomn,plur,inan
тейлором -> ablt,anim,Sgtm,NOUN,Surn,masc,sing
офисной -> sing,gent,ADJF,femn
всем -> Apro,datv,plur,ADJF
цифровые -> ADJF,plur,nomn
kleenex -> LATN
с -> PREP
обмениваться -> INFN,impf,intr
теста -> sing,gent,inan,masc,NOUN
быструю -> accs,ADJF,femn,Qual,sing
проектор -> sing,inan,masc,nomn,NOUN
диссертации -> sing,femn,gent,NOUN,inan
lisa -> LATN
темы -> femn,NOUN,inan,sing,gent
вспоминал -> tran,VERB,past,masc,impf,indc,sing
появляться -> INFN,impf,intr
калифорнийском -> sing,ADJF,masc,loct
персональным -> sing,masc,ablt,ADJF
университет -> NOUN,sing,masc,nomn,inan
количество -> nomn,inan,NOUN,neut,sing
forethought -> LATN
продукта -> inan,sing,NOUN,masc,gent
графикой -> ablt,NOUN,femn,inan,sing
ресурсов -> inan,masc,NOUN,plur,gent
дэном -> NOUN,ablt,sing,Name,anim,masc
графическим -> ablt,ADJF,sing,masc
интернета -> NOUN,sing,masc,gent,inan
коммуникации -> sing,gent,femn,NOUN,inan
школьники -> plur,masc,NOUN,nomn,anim
заложена -> pssv,PRTS,perf,past,sing,femn
кофе -> sing,NOUN,inan,Fixd,masc,ablt
очарованы -> past,plur,perf,pssv,PRTS
тех -> ADJF,Apro,plur,Subx,Anph,gent
написанию -> NOUN,sing,neut,inan,datv
продаж -> gent,inan,femn,plur,NOUN
компиляторы -> anim,NOUN,plur,masc,nomn
графические -> nomn,plur,ADJF
первый -> sing,ADJF,Anum,nomn,masc
от -> PREP
мыши -> femn,plur,NOUN,anim,nomn
для -> PREP
использования -> neut,gent,sing,inan,NOUN
pс -> UNKN
принести -> INFN,perf,tran
пределы -> accs,plur,NOUN,masc,inan
юта -> NOUN,sing,inan,masc,gent
большинства -> Sgtm,neut,inan,gent,sing,NOUN
там -> Dmns,ADVB
ethernet -> LATN
вторжения -> sing,NOUN,neut,gent,inan
собственное -> sing,neut,nomn,ADJF
тактикой -> NOUN,femn,ablt,inan,sing
поэтах -> NOUN,anim,masc,plur,loct
вычислительной -> sing,femn,ADJF,ablt
чрезвычайно -> ADVB
всему -> ADJF,sing,datv,neut,Apro
документов -> inan,masc,NOUN,plur,gent
длилась -> intr,impf,sing,femn,VERB,past,indc
инвестиций -> femn,plur,gent,inan,NOUN
однако -> Prnt,CONJ
excel -> LATN
ориентированную -> sing,tran,femn,PRTF,pssv,perf,accs,past
раздельно -> ADVB
среду -> femn,NOUN,sing,inan,accs
стал -> past,VERB,perf,indc,intr,sing,masc
писал -> masc,sing,tran,VERB,indc,past,impf
трактовался -> past,intr,impf,sing,VERB,indc,masc
финансовое -> neut,ADJF,sing,nomn
ресурсы -> plur,NOUN,masc,nomn,inan
производительности -> femn,inan,NOUN,sing,gent
графической -> femn,gent,ADJF,sing
других -> gent,plur,ADJF,Subx,Apro
целой -> ADJF,gent,Qual,sing,femn
программную -> ADJF,sing,accs,femn
версии -> femn,datv,inan,sing,NOUN
гигант -> NOUN,nomn,sing,inan,masc
перевалило -> tran,sing,VERB,indc,past,neut,perf
этот -> Apro,Subx,accs,ADJF,Anph,sing,masc,inan
отделе -> sing,NOUN,masc,loct,inan
мировое -> nomn,neut,sing,ADJF
штат -> inan,sing,NOUN,nomn,masc
powerpoint -> LATN
вместе -> ADVB
позволяющая -> femn,pres,PRTF,sing,nomn,tran,actv,impf
пакетами -> plur,masc,NOUN,ablt,inan
имеет -> pres,impf,sing,VERB,3per,tran,indc
этого -> NPRO,neut,gent,sing
идея -> nomn,NOUN,inan,sing,femn
карты -> NOUN,gent,sing,inan,femn
усилия -> gent,inan,sing,NOUN,neut
быть -> intr,INFN,impf
изменять -> intr,impf,INFN
исходный -> sing,Qual,ADJF,masc,nomn
полмана -> femn,inan,Sgtm,NOUN,nomn,Geox,sing
бескомпромиссный -> masc,nomn,sing,ADJF
машин -> gent,inan,plur,NOUN,femn
презентация -> NOUN,inan,sing,femn,nomn
делопроизводственная -> ADJF,femn,sing,nomn
vax -> LATN
брендом -> ablt,sing,masc,inan,NOUN
посвятив -> past,perf,tran,GRND
перемещать -> INFN,impf,tran
кодоскопе -> NOUN,loct,masc,sing,inan
разбитых -> ADJF,plur,gent,Qual
собирались -> impf,past,plur,VERB,intr,indc
согласно -> PREP
привлекли -> perf,indc,plur,past,tran,VERB
которую -> ADJF,accs,femn,Subx,Apro,Anph,sing
появившейся -> perf,sing,PRTF,intr,past,ablt,femn,actv
подразделением -> neut,sing,NOUN,ablt,inan
отдел -> inan,masc,sing,NOUN,accs
идеологии -> femn,datv,NOUN,sing,inan
около -> PREP
устройстве -> NOUN,loct,inan,neut,sing
некий -> Apro,masc,nomn,ADJF,sing
продажу -> inan,accs,NOUN,sing,femn
поскольку -> CONJ
программирования -> neut,NOUN,sing,inan,gent
анимированные -> tran,plur,past,perf,pssv,nomn,PRTF
прозрачную -> Qual,femn,sing,ADJF,accs
предшественники -> NOUN,anim,plur,nomn,masc
идеологию -> inan,femn,NOUN,accs,sing
возмущены -> perf,past,pssv,plur,PRTS
к -> PREP
видевшие -> impf,PRTF,actv,plur,nomn,past,tran
парадигму -> inan,sing,accs,NOUN,femn
позволяли -> impf,indc,past,tran,VERB,plur
последних -> ADJF,plur,gent
довольны -> ADJS,Qual,plur
название -> nomn,neut,NOUN,inan,sing
который -> Anph,Subx,sing,masc,Apro,ADJF,nomn
цель -> NOUN,femn,inan,sing,nomn
благодаря -> PREP
виду -> inan,masc,loc2,NOUN,sing
фактические -> ADJF,nomn,plur
текст -> masc,sing,NOUN,nomn,inan
безупречно -> ADVB
его -> sing,3per,accs,Anph,masc,NPRO
команда -> femn,nomn,NOUN,sing,inan
системы -> NOUN,gent,femn,sing,inan
похожий -> masc,sing,nomn,ADJF,Qual
представил -> indc,perf,sing,past,tran,VERB,masc
роба -> inan,sing,nomn,femn,NOUN
одна -> Apro,nomn,sing,femn,ADJF
действие -> inan,NOUN,neut,nomn,sing
совершить -> INFN,tran,perf
предназначена -> pssv,past,femn,PRTS,sing,perf
компьютера -> sing,inan,masc,gent,NOUN
я -> NPRO,1per,nomn,sing
ученые -> plur,masc,anim,nomn,NOUN
колоссальный -> masc,Qual,sing,nomn,ADJF
publishing -> LATN
времени -> gent,neut,NOUN,inan,sing
переломный -> Qual,ADJF,sing,nomn,masc
окнами -> inan,NOUN,plur,ablt,neut
другой -> gent,Apro,sing,ADJF,Subx,femn
полосами -> NOUN,inan,plur,femn,ablt
имя -> sing,inan,NOUN,accs,neut
персональные -> nomn,ADJF,plur
размещается -> intr,VERB,indc,impf,3per,pres,sing
мне -> sing,datv,NPRO,1per
ожидания -> NOUN,sing,gent,neut,inan
сегмент -> masc,accs,sing,inan,NOUN
информацией -> NOUN,inan,ablt,femn,sing
программам -> datv,NOUN,inan,plur,femn
подобно -> ADVB
массачусетском -> loct,sing,ADJF,masc
ожиданий -> NOUN,gent,plur,neut,inan
знакомых -> gent,ADJF,Qual,Subx,plur
проекты -> NOUN,masc,plur,nomn,inan
непосредственно -> ADVB
по -> PREP
технически -> ADVB
победа -> NOUN,femn,nomn,inan,sing
инвесторы -> plur,NOUN,nomn,masc,anim
цена -> femn,nomn,NOUN,inan,sing
переиграть -> tran,perf,INFN
digital -> LATN
облаке -> sing,NOUN,loct,inan,neut
традиционный -> masc,ADJF,sing,nomn
packet -> LATN
убеждения -> neut,gent,NOUN,inan,sing
парням -> datv,masc,NOUN,plur,anim
стратегия -> NOUN,sing,femn,nomn,inan
нашел -> past,indc,tran,sing,perf,VERB,masc
беркли -> Surn,sing,Ms-f,NOUN,GNdr,Fixd,anim,nomn
бывший -> masc,ADJF,sing,nomn
вперед -> ADVB
видеоклипы -> NOUN,inan,masc,plur,nomn
гибким -> masc,Qual,ADJF,sing,ablt
работа -> femn,inan,sing,NOUN,nomn
разработку -> sing,accs,inan,femn,NOUN
программное -> ADJF,sing,nomn,neut
особенно -> ADVB
каждая -> sing,femn,Apro,ADJF,nomn
продуктов -> gent,NOUN,inan,plur,masc
телетайпы -> inan,masc,plur,nomn,NOUN
iii -> ROMN
самое -> sing,ADJF,nomn,Apro,neut
может -> VERB,3per,impf,indc,sing,intr,pres
видении -> neut,NOUN,sing,inan,loct
бросили -> VERB,indc,past,plur,perf,tran
венчурных -> plur,ADJF,gent
нам -> plur,datv,1per,NPRO
невыносимо -> sing,Qual,ADJS,neut
два -> NUMR,masc,nomn
аппаратного -> neut,gent,ADJF,Qual,sing
основан -> pssv,masc,sing,past,perf,PRTS
альто -> Fixd,neut,inan,NOUN,sing,nomn
терминалы -> nomn,NOUN,plur,inan,masc
всех -> gent,ADJF,Apro,plur
более -> ADVB
мониторе -> loct,NOUN,masc,sing,inan
эти -> Subx,ADJF,plur,Anph,Apro,nomn
меркам -> NOUN,femn,plur,datv,inan
фирму -> accs,NOUN,sing,inan,femn
отдельного -> ADJF,gent,Qual,sing,neut
инструмент -> NOUN,accs,masc,sing,inan
такером -> NOUN,ablt,masc,sing,inan
тот -> Subx,masc,Apro,Anph,ADJF,sing,nomn
один -> Apro,sing,nomn,masc,ADJF
macwrite -> LATN
ингаллсом -> sing,ablt,NOUN,inan,masc,Geox
покупать -> INFN,impf,tran
производстве -> sing,neut,loct,NOUN,inan
мира -> masc,sing,NOUN,inan,gent
рода -> NOUN,gent,sing,masc,inan
видим -> impf,1per,pres,tran,VERB,indc,plur
практически -> ADVB
до -> PREP
решили -> perf,plur,tran,indc,VERB,past
хитом -> inan,NOUN,sing,masc,ablt
ними -> NPRO,Af-p,Anph,3per,plur,ablt
новую -> accs,femn,ADJF,Qual,sing
выделить -> perf,INFN,tran
министерства -> NOUN,neut,inan,sing,gent
обыденностью -> ablt,sing,inan,femn,NOUN
smalltalk -> LATN
люди -> anim,plur,NOUN,nomn,masc
лаборатории -> inan,NOUN,femn,sing,gent
они -> 3per,Anph,plur,nomn,NPRO
институте -> NOUN,inan,sing,masc,loct
подразделение -> inan,sing,neut,nomn,NOUN
рынке -> loct,NOUN,inan,masc,sing
equipment -> LATN
проекта -> NOUN,sing,masc,inan,gent
ориентированным -> past,ablt,tran,masc,sing,PRTF,pssv,perf
идее -> femn,sing,datv,NOUN,inan
разработчиков -> masc,anim,gent,plur,NOUN
выпито -> pssv,perf,neut,past,sing,PRTS
работников -> anim,gent,NOUN,plur,masc
hewlett -> LATN
заключающейся -> actv,gent,sing,pres,intr,femn,impf,PRTF
появился -> VERB,intr,past,masc,indc,sing,perf
направленный -> sing,nomn,PRTF,pssv,tran,Adjx,perf,past,masc
руководству -> datv,inan,sing,neut,NOUN
создание -> sing,neut,accs,ANim,NOUN
эта -> sing,Subx,nomn,Anph,Apro,ADJF,femn
вид -> NOUN,masc,sing,inan,accs
современного -> ADJF,gent,sing,neut,Qual
горизонте -> masc,sing,inan,loct,NOUN
распространялся -> sing,masc,indc,impf,intr,VERB,past
баз -> gent,femn,NOUN,plur,inan
macintosh -> LATN
планов -> NOUN,gent,plur,inan,masc
оба -> NUMR,masc,nomn
типографику -> NOUN,masc,sing,datv,anim
компьютере -> inan,loct,masc,NOUN,sing
вместо -> PREP
внешне -> ADVB
работал -> impf,masc,VERB,past,indc,sing,intr
средствах -> neut,plur,inan,NOUN,loct
над -> PREP
код -> nomn,inan,sing,NOUN,masc
графический -> ADJF,nomn,sing,masc
странно -> ADVB,Prdx
стратегию -> sing,accs,inan,NOUN,femn
процедуры -> femn,gent,inan,NOUN,sing
лесного -> neut,gent,sing,ADJF
тесно -> Prdx,ADVB
перфокарты -> femn,gent,sing,NOUN,inan
разрабатывал -> sing,past,impf,indc,VERB,tran,masc
рисунки -> masc,nomn,inan,plur,NOUN
анимацию -> NOUN,inan,accs,Sgtm,sing,femn
фотокопирование -> NOUN,nomn,Sgtm,inan,sing,neut
счета -> inan,sing,gent,masc,NOUN
изображениями -> inan,ablt,neut,NOUN,plur
разработать -> tran,perf,INFN
а -> CONJ
стать -> INFN,perf,intr
интересны -> plur,ADJS,Qual
оснащен -> perf,masc,sing,pssv,past,PRTS
разглядел -> past,indc,sing,perf,tran,VERB,masc
нём -> 3per,sing,loct,masc,Af-p,NPRO,Anph
знакомы -> Qual,ADJS,plur
входить -> intr,INFN,impf
которые -> nomn,Subx,plur,ADJF,Anph,Apro
gui -> LATN
перспективная -> ADJF,sing,nomn,Qual,femn
основали -> tran,perf,plur,indc,past,VERB
популярные -> nomn,plur,Qual,ADJF
технологическом -> loct,sing,masc,ADJF
авторитетные -> plur,nomn,Qual,ADJF
графики -> NOUN,sing,inan,gent,femn
вполне -> ADVB
выходящую -> femn,pres,actv,impf,intr,sing,accs,PRTF
возникли -> VERB,plur,intr,past,perf,indc
первых -> plur,ADJF,gent,Anum
проекторы -> inan,masc,NOUN,nomn,plur
большинству -> NOUN,sing,Sgtm,inan,datv,neut
понятие -> NOUN,nomn,inan,sing,neut
docs -> LATN
слабоват -> sing,Qual,masc,ADJS
двум -> datv,NUMR,masc
превзошел -> tran,sing,indc,perf,past,VERB,masc
технике -> NOUN,sing,inan,femn,datv
же -> PRCL
батлером -> sing,NOUN,inan,masc,ablt
будут -> indc,VERB,intr,plur,3per,futr,impf
безупречна -> femn,sing,Qual,ADJS
руководство -> sing,NOUN,nomn,neut,inan
пользователь -> nomn,anim,sing,NOUN,masc
шоу -> neut,Fixd,inan,NOUN,sing,nomn
агентством -> inan,ablt,sing,NOUN,neut
три -> inan,accs,NUMR
поправилось -> sing,VERB,perf,indc,intr,past,neut
укомплектовывала -> past,sing,impf,indc,VERB,tran,femn
включали -> impf,plur,VERB,past,tran,indc
ооп -> UNKN
слайд -> accs,NOUN,masc,sing,inan
функционировал -> past,VERB,intr,sing,impf,masc,indc
ее -> femn,3per,Anph,gent,sing,NPRO
началось -> perf,indc,intr,VERB,sing,neut,past
электронном -> masc,sing,ADJF,loct
под -> PREP
внедрить -> perf,tran,INFN
можно -> PRED,pres
могли -> plur,indc,impf,VERB,intr,past
вставкой -> ablt,sing,femn,inan,NOUN
скорее -> Prnt,CONJ
америки -> sing,NOUN,Geox,femn,gent,inan,Sgtm
специально -> ADVB
обнародовала -> perf,VERB,femn,indc,sing,past,tran
интерфейсом -> ablt,inan,NOUN,masc,sing
первыми -> plur,ablt,Anum,ADJF
весьма -> ADVB
мы -> NPRO,1per,plur,nomn
бумажные -> plur,ADJF,Qual,nomn
предположил -> perf,VERB,masc,past,tran,indc,sing
поисках -> inan,loct,plur,NOUN,masc
freelance -> LATN
странным -> ADJF,ablt,Qual,masc,sing
осуждают -> plur,VERB,indc,pres,tran,impf,3per
представлял -> VERB,past,indc,sing,tran,impf,masc
поддержке -> loct,NOUN,femn,inan,sing
компания -> NOUN,inan,sing,nomn,femn
правительственный -> nomn,sing,ADJF,masc
покинули -> indc,tran,plur,perf,past,VERB
американские -> nomn,ADJF,plur
площадка -> NOUN,nomn,inan,femn,sing
приобрел -> sing,past,perf,masc,indc,VERB,tran
parc -> LATN
интернет -> inan,NOUN,masc,nomn,sing
несмотря -> PREP
пользователей -> plur,gent,NOUN,masc,anim
дугласа -> sing,Name,anim,gent,masc,NOUN
менеджера -> masc,sing,accs,NOUN,anim
напротив -> CONJ,Prnt
мощный -> nomn,masc,sing,ADJF,Qual
всего -> ADVB
инсайдеров -> plur,gent,masc,anim,NOUN
нанятый -> masc,pssv,tran,nomn,PRTF,past,sing,perf
слабые -> plur,ADJF,Qual,nomn
закончив -> perf,GRND,past,tran
современным -> Qual,datv,ADJF,plur
умели -> VERB,intr,past,plur,indc,impf
содержащие -> actv,nomn,tran,impf,PRTF,plur,pres
максимально -> ADVB
зарегистрировала -> tran,sing,VERB,indc,femn,past,perf
копий -> femn,plur,gent,inan,NOUN
провалился -> past,sing,indc,VERB,perf,masc,intr
проще -> Qual,COMP
справлялся -> sing,indc,impf,VERB,masc,intr,past
чаком -> Name,ablt,anim,masc,NOUN,sing
подтолкнул -> indc,sing,tran,masc,perf,past,VERB
приложениями -> neut,plur,inan,NOUN,ablt
пожара -> NOUN,inan,gent,sing,masc
ii -> ROMN
существовало -> indc,sing,intr,VERB,impf,neut,past
парадигмы -> femn,inan,NOUN,gent,sing
самых -> ADJF,Apro,plur,gent
своей -> sing,ADJF,gent,femn,Apro,Anph
годов -> gent,masc,NOUN,inan,plur
таким -> Apro,datv,plur,ADJF
конкуренты -> masc,NOUN,plur,anim,nomn
делать -> impf,INFN,tran
окончательно -> ADVB
локальными -> ablt,plur,ADJF,Qual
миллиардов -> inan,plur,masc,gent,NOUN
рассказали -> indc,tran,VERB,plur,past,perf
сих -> Subx,Apro,ADJF,gent,plur
белыми -> ADJF,plur,Qual,ablt
персональный -> ADJF,masc,sing,nomn
базы -> gent,femn,sing,inan,NOUN
общались -> impf,past,plur,VERB,indc,intr
сравнению -> sing,neut,inan,datv,NOUN
первопроходца -> masc,anim,NOUN,gent,sing
тексты -> masc,plur,inan,accs,NOUN
современное -> sing,nomn,neut,Qual,ADJF
sri -> LATN
так -> CONJ
вырезанием -> NOUN,ablt,sing,neut,inan
фондов -> gent,plur,masc,NOUN,inan
стэнфорде -> masc,loct,sing,NOUN,inan
некоторые -> Apro,plur,nomn,ADJF
имена -> inan,plur,accs,NOUN,neut
тема -> femn,nomn,NOUN,inan,sing
том -> sing,Anph,neut,ADJF,Subx,loct,Apro
человеческие -> nomn,plur,ADJF
другими -> Apro,Subx,ablt,ADJF,plur
намеревались -> past,indc,intr,VERB,plur,impf
отрасль -> femn,nomn,inan,sing,NOUN
xerox -> LATN
остин -> nomn,anim,Surn,Sgtm,sing,masc,NOUN
разрешения -> sing,neut,NOUN,gent,inan
заполучить -> tran,perf,INFN
только -> PRCL
распечатывать -> impf,INFN,tran
но -> CONJ
протокол -> NOUN,inan,accs,sing,masc
неплохой -> nomn,ADJF,sing,masc
такими -> ablt,Apro,ADJF,plur
специалисты -> plur,nomn,NOUN,anim,masc
часть -> sing,inan,nomn,NOUN,femn
меняется -> pres,indc,impf,VERB,intr,3per,sing
систему -> NOUN,sing,femn,inan,accs
электронными -> ablt,ADJF,plur
набирал -> past,indc,impf,tran,sing,VERB,masc
разработчиками -> NOUN,ablt,masc,anim,plur
ноутбука -> gent,masc,inan,NOUN,sing
аналогии -> femn,inan,gent,NOUN,sing
перенести -> perf,INFN,tran
голубой -> sing,ablt,anim,NOUN,Ms-f,femn
машины -> sing,NOUN,gent,femn,inan
поставщиками -> ablt,plur,anim,masc,NOUN
новые -> nomn,NOUN,neut,plur,inan
многие -> nomn,plur,NPRO
изображение -> NOUN,sing,neut,nomn,inan
ориентированном -> tran,loct,pssv,masc,perf,PRTF,past,sing
провала -> sing,masc,inan,NOUN,gent
поняли -> indc,VERB,tran,perf,past,plur
ушел -> intr,VERB,perf,past,sing,indc,masc
графика -> sing,masc,NOUN,gent,anim
оставаться -> intr,INFN,impf
стартап -> sing,masc,NOUN,inan,nomn
вначале -> ADVB
после -> PREP
просто -> PRCL
даже -> PRCL
управление -> inan,nomn,NOUN,neut,sing
была -> VERB,past,femn,intr,indc,sing,impf
пленку -> NOUN,femn,accs,sing,inan
докторские -> plur,nomn,ADJF
ранние -> nomn,ADJF,plur
обойти -> INFN,perf,tran
проник -> intr,sing,past,indc,VERB,perf,masc
оставить -> INFN,perf,tran
маркетинг -> inan,masc,accs,sing,NOUN
работе -> loct,femn,sing,NOUN,inan
созданную -> PRTF,perf,past,pssv,femn,sing,accs,tran
офисных -> ADJF,gent,plur
увиденным -> tran,sing,masc,past,ablt,perf,PRTF,pssv
тейлор -> NOUN,nomn,anim,Surn,Sgtm,masc,sing
похвастаться -> INFN,intr,perf
windows -> LATN
текстом -> NOUN,ablt,masc,sing,inan
издании -> sing,neut,loct,NOUN,inan
те -> Anph,ADJF,Apro,Subx,nomn,plur
нарицательным -> ADJF,masc,ablt,sing
ряд -> NOUN,nomn,masc,sing,inan
своего -> ADJF,neut,Anph,Apro,sing,gent
использовали -> indc,tran,VERB,perf,plur,past
pup -> LATN
принцип -> nomn,masc,NOUN,inan,sing
вскоре -> ADVB
требовался -> sing,indc,intr,impf,masc,VERB,past
обеспечения -> inan,NOUN,sing,neut,gent
нему -> Af-p,sing,3per,masc,Anph,NPRO,datv
автоматизации -> inan,sing,gent,femn,NOUN
маркетинге -> inan,sing,loct,masc,NOUN
файлов -> plur,NOUN,inan,masc,gent
пропадают -> impf,3per,intr,pres,indc,plur,VERB
искушенные -> PRTF,nomn,pssv,perf,plur,tran,past
ориентированного -> tran,masc,perf,past,pssv,PRTF,sing,gent
языком -> sing,ablt,inan,masc,NOUN
месяц -> inan,NOUN,sing,accs,masc
бобом -> NOUN,ablt,anim,Name,masc,sing
чем -> CONJ
меню -> NOUN,neut,inan,nomn,Fixd,sing
контекстного -> ADJF,sing,Qual,masc,gent
burroughs -> LATN
инвестиции -> femn,NOUN,inan,gent,sing
исследований -> gent,neut,plur,NOUN,inan
рассчитывала -> indc,past,sing,impf,intr,femn,VERB
год -> inan,masc,sing,NOUN,accs
новой -> gent,femn,sing,ADJF,Qual
поначалу -> ADVB
внедрив -> perf,tran,past,GRND
потребуется -> sing,futr,intr,VERB,indc,perf,3per
отчеты -> nomn,inan,NOUN,masc,plur
именно -> PRCL
корпус -> accs,inan,masc,NOUN,sing
докладов -> gent,plur,masc,NOUN,inan
устроиться -> perf,intr,INFN
многое -> Apro,nomn,neut,sing,ADJF
ведет -> sing,3per,impf,tran,pres,indc,VERB
информация -> femn,sing,NOUN,nomn,inan
фирмы -> gent,inan,sing,NOUN,femn
программированию -> NOUN,datv,sing,inan,neut
то -> CONJ
конференций -> gent,plur,NOUN,inan,femn
визуальный -> masc,Qual,ADJF,sing,nomn
создававшие -> tran,plur,actv,nomn,past,impf,PRTF
